{
    "name" : "Level 3",
    "time" : 8,
    "size" : {
        "width" : 20,
        "height" : 10
    },
    "map" : [[
        1,1,1,1,1,1,1,1,1,1,1,1,1,1,1,1,1,1,1,1,
        1,0,0,0,0,0,0,0,0,0,0,0,0,0,0,0,0,0,0,1,
        1,0,0,0,0,0,0,0,0,0,0,0,0,0,0,0,0,0,0,1,
        1,0,0,5,0,0,0,0,0,0,0,0,0,0,0,0,0,0,0,1,
        1,0,0,1,1,0,0,4,0,0,0,0,0,0,0,0,0,0,0,1,
        1,0,0,0,0,0,0,1,1,0,0,3,0,0,0,0,0,0,1,1,
        1,0,11,0,0,0,0,0,0,0,1,1,0,0,0,1,1,1,1,1,
        1,0,0,0,0,0,0,0,0,0,0,0,0,0,1,1,1,1,1,1,
        1,1,1,1,1,1,1,0,0,0,0,0,1,1,1,1,1,1,1,1,
        1,1,1,1,1,1,1,1,1,1,1,1,1,1,1,1,1,1,1,1
    ]]
}