{
    "name" : "Level 2",
    "time" : 10,
    "size" : {
        "width" : 20,
        "height" : 10
    },
    "map" : [[
        1,1,1,1,1,1,1,1,1,1,1,1,1,1,1,1,1,1,1,1,
        1,0,0,0,0,0,0,0,0,0,0,0,0,0,0,0,0,0,0,1,
        1,0,0,0,0,0,0,0,0,0,0,0,0,0,0,0,0,0,0,1,
        1,0,0,0,0,0,0,0,0,0,0,0,0,0,0,0,0,0,0,1,
        1,0,0,0,3,4,5,0,0,0,0,0,0,0,0,0,0,0,0,1,
        1,0,0,0,0,1,1,0,0,1,1,0,0,0,0,0,0,0,0,1,
        1,0,11,0,0,0,0,0,0,0,0,0,1,1,0,0,0,0,0,1,
        1,0,0,0,0,0,0,0,0,2,10,0,0,0,0,0,0,0,0,1,
        1,1,1,1,1,1,1,1,1,1,1,1,1,1,1,1,1,1,1,1,
        1,1,1,1,1,1,1,1,1,1,1,1,1,1,1,1,1,1,1,1
    ]]
}