{
    "name" : "Level 2",
    "time" : 15,
    "size" : {
        "width" : 20,
        "height" : 10
    },
    "map" : [[
        1,1,1,1,1,1,1,1,1,1,1,1,1,1,1,1,1,1,1,1,
        1,0,0,3,1,0,0,0,0,11,0,0,0,0,0,1,4,0,0,1,
        1,1,0,0,1,0,0,0,0,0,0,0,0,0,0,1,0,0,1,1,
        1,0,0,1,1,0,0,0,0,0,0,0,0,0,0,1,1,0,0,1,
        1,1,0,0,1,0,0,0,0,0,0,0,0,0,0,1,0,0,1,1,
        1,0,0,1,1,0,0,0,0,0,0,0,0,0,0,1,1,0,0,1,
        1,1,0,0,1,0,0,0,0,6,6,0,0,0,0,1,0,0,1,1,
        1,0,0,0,0,0,0,1,1,1,1,1,1,0,0,5,0,0,0,1,
        1,1,1,1,1,1,1,1,1,1,1,1,1,1,1,1,1,1,1,1,
        1,1,1,1,1,1,1,1,1,1,1,1,1,1,1,1,1,1,1,1
    ]]
}